0001000001
0111110101
0100010101
0111011101
0001010001
0111010101
0100010101
0111011101
0001000001
1111111111
